25 20
#############
#...........#    ########
#...s...s...######......#
#............d..........#
#...........######......#
#.....s.....#    #......#
#...........#    #....y.#
#...........#    #......#
#####..######    ###..###
    #.k#           ##.#
    #..#            #d#
    #l.#          ###.##
  ###..####      #......#
  #..@..p.#      #......#
  #.......#      #......#
  #.......#      #......#
  #.......#      #......#
  #.......#      #......#
  #.......#      #......#
  #########       ######
